....................
....................
....................
....................
....................
....................
.......###..........
....................
##################.#